   ***********************************************
*  *********                         *************
*  *********  **********************  ************
*  *********  ***********************  ***********
*  *********  ************************  **********
*  *********  ***********************   **********
*  *********  ********************    ************
*  *********  ******************   ***************
*  *********  **                  ****************
*  *********  *******   **************************
*  *********  *********   ************************
*  *********  ***********   **********************
*  *********  *************   ********************
*  *********  ***************   ******************
*  *********  *****************   ****************
*  *********  *******************   **************
*  *********  *********************   ************
*  *********  ***********************   **********
*  *********  *************************  *********
*  *********  **************************    ******
*  *********  *****************************  *****
*                                      *****  ****
*********************************************     
