  ******************
* *  * *    *      *
  *  ****** * * *  *
 **    *     **** **
 ******* **        *
    **** **** ******
**     *   *       *
** *  ** **  *******
** * *** ***  ******
** * ***    *  *****
** *     *****      
******************* 
