   ***********************************************
*  *********                         *************
*  *********  **********************  ************
*  *********  ***********************  ***********
*  *********  ************************  **********
*  *********  ************************  **********
*  *********  ***********************   **********
*  *********  **********************  ************
*  *********  ********************   *************
*  *********  *******************  ***************
*  *********  ******************  ****************
*  *********  **                 *****************
*  *********  **  ********************************
*  *********  ***  *******************************
*  *********  ****  ******************************
*  *********  *****  *****************************
*  *********  ******  ****************************
*  *********  *******  ***************************
*  *********  ********  **************************
*  *********  *********  *************************
*  *********  **********  ************************
*  *********  ***********  ***********************
*  *********  ************  **********************
*  *********  *************                 ******
*  *********  *****************************  *****
*                                      *****  ****
*********************************************     
